OXXXXXXX
XXOOXOOX
XOXOXOXX
XOXOXOOX
XOXOAXOX
XOXOXOOX
XOXOOOBX
XXXXXXXX
