XXXXXXXX
XOOOXOBX
XOXOXOXX
XOXOXOOX
XOXOXXOX
XOXOXOOX
XAXOOOXX
XXXXXXXX
